00000000000000000000
01111111111100000000
00000010000000000000
00000001000000000000
00000000100000000000
00000000010000000000
00000000001000000000
00000000000000000000
00000000000000000000
00000000000000000000
00000000000000000000
00000000000000000000
00000000000000000000
00000100000000000000
00000010000000000000
00000001000000000000
00000000100000000000
00000000010000000000
00000000001000000000
00000000000100000000
00000000000010000000
00000000000001111111
00000000000000100000
00000000000000010000
00000000000000001000